           ########
           #..TTTT#
############..TTTT#
#....#....C....TT.#
#...C.#.C.C...TTT.#
#..C.....C.#..TTTT#
#.CC.#C.C.C#########
#..C.#.....#
##.#########
#....#....##
#.....C...##
#..CC#CC..@#
#....#....##
###########
