        ########
        #.....@#
        #.C#C.##
        #.C..C#
        ##..C.#
#########.C#..###
#TTTT..##.C..C..#
###TT....C..C...#
#TTTT...#########
#########
